

"http://192.168.0.121:8080/nsbd/Service/dataSync.do?"


 public static String xunchaaction = "taskstart";
    public static String jibentianbao = "taskbase";
    public static String renwuliebiaoaction = "taskconfig";
    public static String jinghaoliebiaoaction = "taskfacility";
    public static String dongguanaction = "dgqline";
    public static String dongfen = "dgqwater";
    public static String dgqquerywater = "dgqquerywater";
    public static String dgqqueryair = "dgqqueryair";
    public static String dongqi = "dgqair";
    public static String dnqueryline = "dnqueryline";
    public static String dgqqueryline = "dgqqueryline";
    public static String ngqqueryline = "ngqqueryline";
    public static String dongkong = "dgqwell";
    public static String dgqquerywell = "dgqquerywell";
    public static String daline = "dnline";
    public static String dnair = "dnair";
    public static String dnqueryair = "dnqueryair";
    public static String dnquerywell = "dnquerywell";
    public static String dnwell = "dnwell";
    public static String ngqline = "ngqline";
    public static String ngqair = "ngqair";
    public static String ngqwell = "ngqwell";
    public static String ngqquerywell = "ngqquerywell";
    public static String queryhistory = "queryhistory";
    public static String ngqqueryair = "ngqqueryair";
    public static String file = "file";
    public static String tufashangbao = "incident";
    public static String wodetufashijian = "incidentTask";
    public static String queryfacility="queryfacility";